###############
#2**2**2**2**2#
#  *LL***LL*  #
#  *LLL*LLL*  #
#  **L***L**  #
# **#L*L*L#** #
# ** ***** ** #
#  * **F** *  #
#W    WWW    W#
#*WW WWWWW WW*#
#*    ***     #
#  ** ***  ** #
#*   LLLLL   *#
#    WWWWW    #
# **   @   ** #
###############