###############
#  6  ***  6  #
# *** *** *** #
# ***  2  *** #
#LLL*******LLL#
#*LLLL***LLLL*#
## ** *** ** ##
#  **     **  #
#  ** *** **  #
#LLL       LLL#
# **   *   ** #
# *** * * *** #
#  *** F ***  #
#*   *****   *#
#**    @    **#
###############