###############
#1     E     1#
# ***** ***** #
# ***** ***** #
#    ** **    #
# ** * 1 * ** #
#             #
##   *###*   ##
#  * ***** *  #
#  * * * * *  #
#  * * * * *  #
#  * * * * *  #
#  *   @   *  #
#     ***     #
#     *F*     #
###############