###############
#5     E     5#
# ***** ***** #
# ***** ***** #
#    ** **    #
# ** *   * ** #
#             #
##   *###*   ##
#  * ***** *  #
#  * * * * *  #
#  * * * * *  #
#  * * * * *  #
#  *   @   *  #
#     ***     #
#     *F*     #
###############