###############
# 1      4   ##
#            ##
#            ##
#            ##
#            ##
#            ##
#            ##
# LLLLLLLLL   #
# WWWWWWWWW   #
#      E E    #
#   * * *     #
##***         #
#   #   ***   #
#     @ **F   #
###############